11 21
1 1
9 19
111111111111111111111
1S0000001000100010001
101111101010101110111
101000000010001000101
101111101111111011101
100000101000100010001
101110101010101111101
101000101010101000001
101011111010101011101
1010000000100000100E1
111111111111111111111
