11 21
1 1
9 19
111111111111111111111
1S0000000000000000101
101111111111101110101
101000100000001010001
111010101111111011101
100010001000100010001
101111111011101010111
100000100010001010101
101110101110111110101
1000100010000000000E1
111111111111111111111
